****X*****X***X*X***
X*XXX*XXX*X*X*X*X*X*
X*****X***X*X*****X*
X*XXX*X*XXX*X*XXXXX*
X***X*X*****X*X*****
XXX*X*XXXXXXX*X*XXXX
X***X*****X***X*****
X*XXXXXXX*X*XXXXXXX*
X*****X***X*****X***
XXXXX*XXXXXXXXX*X*XX
X*X***X*********X*X*
X*X*X*X*X*XXXXXXX*X*
X***X*X*X*X*X*****X*
XXXXX*X*X*X*X*X*XXX*
X***X*X*X***X*X*X***
X*X*X*X*XXXXX*X*X*X*
X*X*X*X***X***X*X*X*
X*X*X*XXX*X*XXXXX*X*
X*X***X***X*******X*
XXXXXXXXXXXXXXXXXXX*