**XXXXX
X*XXXXX
X*XXXXX
X****XX
X*XX*XX
X*XXXXX
X******