****X*****X***X*****
X***X*X*X*X*X*X*XXX*
X*****X*X***X*X*****
XXXXXXX*X*X*X*X*X*X*
X*****X*X*X*X***X*X*
X*XXX*X*X*X*XXX*X*X*
X***X*****X***X*X***
X*X*X*XXXXXXX*X*XXX*
X*X*X*X*****X*X*****
X*X*X*X*X*X*X*XXXXXX
X*X*X*X*X*X*X*******
X*X*X*X*X*X*XXXXXXX*
X*X***X*X*X*******X*
X*XXX*X*X*X*X*XXX*X*
X*X***X***X*X***X***
X*X*XXXXX*X*XXX*XXXX
X*X*X***X*X***X*X***
X*X*X***X*XXX*X*X***
X*******X*****X*****
XXXXXXXXXXXXXXXXXXX*