************X*X***X*****X***X*X*********X*************X***********X*************X***X***X*********X*
X*X*XXX*XXX*X*X*X*X*X*X*X*X*X*X*X*XXXXXXX*X*XXXXX*X*XXX*X*XXXXXXX*X*XXXXXXXXXXXXX*X*X*X*X*XXXXX*X*X*
X*X***X***X*X***X***X*X***X*X***X*********X***X*X*X***X*X*X***X*X***********X*****X*X*X***X*****X***
X*X*XXXXX*XXX*XXX*X*X*XXXXX*X*X*X*XXXXXXXXXXX*X*X*X*X*X*X*X*X*X*XXXXXXXXXXX*X*X*X*X*X*X*XXX*X*XXXXXX
X*X*X***X*****X***X*X*****X*X*X*X*****X*****X*X*X*X*X***X*X*X***X*********X***X*X*X***X*X*X*X*******
X*XXX*XXXXX*XXX*XXX*XXXXX*XXX*X*XXXXX*X*XXX*X*X*X*X*X*XXX*X*X*XXX*X*XXXXX*XXXXX*X*X*XXX*X*X*XXXXXXX*
X***X*****X*X***X***X***X*****X*X*****X***X***X*X*X*X***X***X***X*X*****X*X***X*X*X***X*X***X*******
X*X*XXXXX*X*X*XXX*XXX*X*XXXXX*X*X*XXXXX*X*X*XXX*X*X*X*XXXXX*XXXXX*X*XXXXX*X*X*X*X*XXXXX*XXXXX*X*XXXX
X*X*X*****X*X*X*X*****X*X***X*X*X*X***X*X*X***X*X*X*X*X***X*X***X*X*X***X*X*X*X*X*****X***X***X*****
X*X*X*X*XXXXX*X*XXXXXXX*X*X*XXX*X*XXX*X*X*XXXXX*X*X*XXX*X*XXX*X*X*X*X*X*X*X*X*X*XXXXX*XXX*XXXXXXXXXX
X*X***X***X***X*********X*X*****X*****X*X*******X*X*****X*****X***X*X*X*X*X*X*X*****X***X***********
X*X*XXXXX*X*XXXXXXX*XXXXXXXXXXXXX*XXXXX*XXX*XXXXX*XXXXXXXXX*XXXXXXX*X*XXX*X*X*XXXXX*XXX*X*XXXXXXXXX*
X*X*X***X*X*******X*X***X***X***X*X***X***X*X***X*********X*****X*X*X*X***X*X*X*****X***X*****X***X*
X*X*XXX*X*X*XXXXX*X*X*XXX*X*X*X*XXX*XXXXX*X*XXX*X*XXX*X*X*XXXXX*X*X*X*X*XXXXX*X*XXXXXXXXX*XXX*X*X*X*
X*X*X***X*X***X*X*X***X***X***X*X***X***X*X*****X***X*X*X*****X***X*X*X*X*****X***X***X***X***X*X*X*
X*X*X*X*X*XXX*X*X*XXXXX*X*XXXXX*X*XXX*X*X*X*XXXXX*X*X*XXXXXXX*XXXXX*X*X*X*XXXXXXX*X*X*X*X*X*XXX*X*X*
X*X***X*X*X***X*X*X***X*X***X***X***X*X***X*X***X*X*X*****X***X*****X***X*******X*X*X***X*X***X*X***
X*X*XXX*X*X*XXX*X*X*X*X*XXXXX*XXXXX*X*XXXXX*X*X*XXX*XXXXXXX*X*X*X*X*XXXXXXXXXXX*X*X*XXXXXXXXX*X*XXXX
X*X*X***X*X***X*X*X*X*X*****X*****X***X*****X*X*X***X*******X*X*X*X***X*****X***X*X***X*******X*X***
X*XXX*XXX*XXX*X*X*X*X*XXXXX*X*XXX*X*XXX*XXXXX*X*X*XXX*X*XXXXXXX*X*XXXXX*XXXXX*XXX*XXX*X*XXXXXXX*X*X*
X*X***X***X***X*X***X***X***X***X*X***X***X***X*X*X***X*X*X*****X***X***X***X*****X***X***X***X***X*
X*X*XXX*X*X*XXX*X*XXXXX*XXXXXXXXX*XXX*X*X*X*XXXXX*X*XXX*X*X*XXXXXXX*X*XXX*X*XXX*XXX*X*X*X*X*X*XXXXXX
X*X***X*X*X*****X*X***X***********X***X*X*X***X***X***X***X***X***X*X***X*X***X*X***X*X*X***X*******
X*XXX*X*XXXXXXXXX*X*X*XXXXXXXXXXXXX*XXXXX*XXX*X*XXXXX*X*XXXXX*X*X*XXXXX*X*XXX*XXX*X*XXX*X*X*XXXXXXX*
X*X***X*****X***X*X*X*******X*****X*****X*X***X*X***X*X*****X***X*X***X*X*X*X*****X*X***X*X*X*****X*
X*XXXXXXXXX*X*X*X*X*X*XXXXXXX*X*X*XXXXX*X*X*XXX*X*X*X*XXXXX*XXXXX*X*X*X*X*X*X*XXXXX*X*X*X*XXX*XXX*X*
X*****X***X*X*X*X*X*X*X*****X*X*X***X***X***X***X*X*X***X*X*****X***X*X*X***X***X*X*X*X*X***X***X*X*
XXXXX*X*X*X*X*X*XXX*X*X*X*X*X*X*XXX*XXXXXXXXX*X*X*XXXXX*X*XXXXX*X*XXX*X*XXXXXXX*X*X*X*XXX*X*XXXXX*X*
X***X***X*X***X***X*X*X*X*X***X*X*X*******X***X*X*******X*X*****X***X***X*****X***X*X***X*X*****X*X*
X*XXXXXXX*X*XXXXX*X*XXX*X*X*XXX*X*X*XXXXX*X*XXX*X*X*XXXXX*X*XXX*XXX*XXXXXXXXX*X*XXX*XXX*X*XXXXX*X*X*
X***X*****X*X***X*X*****X*X***X*X*X*****X***X***X*X*****X*X***X*X***X*********X***X***X*X*****X***X*
X*X*X*X*XXX*X*X*X*X*XXX*X*XXXXX*X*XXXXX*X*XXX*XXX*XXXXX*X*XXX*X*X*XXX*XXXXX*XXXXX*X*X*X*XXX*XXXXXXX*
X*X***X*X***X*X***X***X*X***X***X*X***X*X***X*X***X***X*X*X***X*X*****X***X***X*X*X*X*X***X*X***X***
X*XXXXX*X*X*X*XXXXXXX*XXXXX*X*XXX*X*XXX*XXXXX*XXX*X*X*XXX*X*X*X*XXXXXXX*X*X*X*X*X*X*X*XXX*XXX*X*X*X*
X*X***X*X*X*X*******X*****X*X*****X***X*X***X***X*X*X*****X*X*X*X*****X*X*X*X***X*X*X***X***X*X*X*X*
X*X*X*XXX*X*XXX*XXX*XXXXXXX*XXXXXXX*X*X*X*X*XXX*X*X*X*XXXXX*XXX*X*XXX*XXX*XXXXXXX*XXXXX*XXX*XXX*X*X*
X*X*X*****X***X***X***X***X*X*****X*X***X*X***X*X*X*X*****X***X*X***X***X*******X*****X***X*X***X*X*
X*X*XXXXXXXXX*XXX*X*X*X*X*X*X*XXX*XXXXXXX*XXX*X*X*X*XXXXX*XXX*X*XXX*X*X*XXX*XXX*XXXXXXXXXXX*X*XXX*X*
X*X*X*X***X***X***X*X*X*X*X***X***X*****X*X*X***X*X*****X*X***X*****X*X***X***X*******X***X*X*X***X*
X*X*X*X*X*X*XXX*X*XXX*X*X*XXXXX*X*X*XXX*X*X*XXX*X*XXXXX*X*X*XXXXX*XXX*X*X*XXXXXXXXXXX*X*X*X*X*X*XXXX
X*X*X***X***X***X*X***X*X*****X*X*X***X*X*X***X*X*X***X*X*X*****X*X***X*X***********X*X*X*X***X*****
X*X*XXXXXXXXX*X*X*X*XXXXXXXXX*X*X*XXX*XXX*X*X*XXX*X*X*X*XXXXXXX*X*X*XXXXXXXXXXXXXXX*X*X*X*XXX*XXXXX*
X*X*X*****X***X*X*X*****X***X***X***X***X*X*X***X*X*X*X*********X*X*X*************X***X*X***X*X*****
XXX*X*XXX*X*XXX*X*XXXXX*X*X*XXXXXXX*X*X*X*X*XXX*X*X*X*XXXXXXXXXXX*X*X*X*XXXXXXXXX*X*XXX*XXX*XXX*X*XX
X***X***X***X***X***X***X*X*********X*X***X*X***X***X*X***X*******X***X*********X*X***X***X***X*X*X*
X*XXXXXXXXXXX*X*XXX*X*XXX*XXXXXXXXXXXXXXXXX*X*XXXXXXX*X*XXX*XXXXXXXXXXXXXXXXXXX*X*XXXXX*X*XXX*X*X*X*
X*X*****X*****X*X*X*X***X*****X*********X*X*X*********X*****X*******X***********X*X*****X***X***X***
X*XXXXX*X*XXXXX*X*X*X*X*XXXXX*X*XXXXXXX*X*X*XXXXXXXXXXXXXXXXX*XXXXX*X*X*XXXXXXXXX*X*XXX*XXX*X*X*XXXX
X*****X*X*****X***X*X*X*X***X*X*X***X***X***X*****************X***X***X*X*********X***X*X***X*X*X***
X*XXX*X*XXXXX*XXXXX*X*X*X*X*XXX*X*XXX*X*XXXXX*X*XXXXXXXXXXXXXXX*X*XXXXXXX*X*XXXXX*XXX*XXX*X*X*X*X*X*
X*X*X***X*****X*****X*X***X*****X*****X*X*****X*X***X*****X*****X***X*****X*X***X***X***X*X*X*X***X*
X*X*X*XXX*X*XXX*XXX*X*XXXXXXXXXXXXXXXXX*X*X*XXX*X*X*X*XXX*X*XXXXX*X*X*XXXXX*X*X*XXX*XXX*X*XXX*XXXXX*
X***X*X***X***X***X*X***********X*****X*X*X***X*X*X*X***X***X***X*X***X***X***X***X*X***X*X***X***X*
X*XXXXX*XXXXX*X*X*XXXXXXXXXXXXX*X*XXX*XXX*XXXXX*X*X*X*X*XXXXX*X*X*XXXXX*XXXXXXXXX*XXX*X*X*X*XXX*X*XX
X*X*X***X*****X*X***********X*X*X*X***X***X***X***X*X*X***X***X*X*****X***********X***X*X*X***X*X***
X*X*X*XXX*XXXXX*XXXXX*XXXXX*X*X*X*X*X*X*XXX*X*XXXXX*XXXXX*X*XXX*XXXXX*X*XXXXXXX*XXX*XXX*X*XXXXX*XXX*
X***X***X***X***X***X*X*****X*X***X*X*X***X*X*******X***X*X***X*X***X*X*******X***X*X***X*****X*X***
XXXXXXX*XXX*XXXXX*X*X*X*XXX*X*XXXXX*X*XXX*X*XXXXXXX*X*XXX*XXX*X*XXX*X*X*XXXXX*X*X*X*XXXXXXXXX*X*X*XX
X*****X*X***X***X*X*X*X***X*X*X*****X***X*X***X***X*X***X***X*X***X***X***X*X*X*X*X*****X***X***X***
X*XXXXX*X*XXX*X*X*X*XXX*X*XXX*X*X*XXXXX*X*X*X*X*X*X*XXX*X*X*X*XXX*XXXXXXX*X*X*X*X*X*XXX*X*X*XXXXXXX*
X*X*****X*X***X***X***X*X***X***X*X*****X*X*X*X*X*X***X*X*X***X*X***X***X*X*X*X*X*X*X*X***X***X*X***
X*X*X*XXX*X*XXXXXXXXX*XXXXX*XXXXX*X*XXXXX*X*X*XXX*XXXXX*X*XXXXX*XXX*X*X*X*X*X*XXX*X*X*XXX*XXX*X*X*X*
X*X*X*X***X*X***X***X*******X*****X*****X*X*X*****X*****X*******X***X*X*X***X*X***X*X***X***X***X*X*
X*X*X*X*X*X*X*X*XXX*XXXXXXXXX*XXXXXXXXX*X*X*XXXXXXX*X*XXXXX*XXXXX*XXX*X*XXXXX*X*XXX*XXX*XXX*XXXXX*X*
X***X*X*X*X*X*X*****X***X***X*X*******X*X*X*X*X*****X*****X*****X*X***X*X***X*X***X*****X*X*X*****X*
X*XXXXX*X*X*X*X*XXXXXXX*X*X*XXX*X*XXX*XXX*X*X*X*XXXXXXXXX*XXXXX*X*X*XXX*X*X*X*XXX*X*XXXXX*X*X*XXXXX*
X*X*****X*X*X*X*X*X***X*X*X*****X***X***X*X***X*****X***X***X***X***X***X*X***X***X*****X***X*****X*
X*X*XXXXX*X*X*X*X*X*X*X*X*XXXXX*XXX*XXX*X*X*XXXXXXX*XXX*XXX*X*X*XXXXX*X*X*XXXXX*XXXXXXX*X*XXXXXXX*X*
X*X***X***X***X***X*X***X*****X***X*X*X*X*X*******X***X*****X*X*****X*X*X*X***X*X*******X*****X***X*
X*X*X*XXX*XXXXXXXXX*XXXXXXXXX*XXX*X*X*X*X*XXXXXXX*XXX*XXXXX*X*XXXXXXX*X*X*X*X*X*X*XXXXXXXXXXX*X*XXXX
X*X*X***X*X***X***X***********X***X*X*X***X*******X***X***X*X*X*******X*X*X*X***X***X*****X***X*****
X*XXXXX*X*X*X*X*X*XXXXXXX*XXXXXXXXX*X*XXX*X*X*X*XXX*XXX*X*XXX*X*XXXXXXX*X*XXX*XXX*X*X*XXX*X*X*XXXXX*
X*****X*X***X*X*X*******X*X*********X***X*X*X*X*X***X***X*****X***X*****X***X***X*X***X***X*X*X***X*
X*XXX*X*XXXXX*X*XXXXXXX*XXX*X*X*X*XXXXX*XXX*X*X*X*XXX*XXXXXXXXXXX*X*XXXXXXX*X*X*XXX*XXX*X*X*XXX*X*X*
X***X*X***X***X*X***X***X***X*X*X***X***X***X*X*X*X***X*****X*****X*****X***X*X***X***X*X*X*****X*X*
X*XXX*X*X*XXXXX*X*XXX*XXX*XXX*X*XXXXX*XXX*XXX*X*X*XXXXX*XXX*X*XXXXXXXXX*X*XXX*X*X*XXX*X*X*XXXXXXX*X*
X*X***X*X*******X*X***X***X***X*X*****X***X***X*X*******X***X*X***X***X*X*X*X*X*X***X*X*X***X***X*X*
XXX*X*X*XXXXXXXXX*X*XXX*X*X*XXXXX*X*XXX*XXXXXXXXXXXXX*X*X*XXX*X*X*X*X*X*X*X*X*XXXXX*XXX*XXX*X*X*XXX*
X***X*X*******X***X***X*X*X*****X*X***X***X***X*****X*X*X***X*X*X*X*X*X*X*X*X*X*****X***X***X*X*****
X*X*X*XXXXXXX*X*XXXXX*X*XXXXX*X*X*XXX*XXX*X*X*X*XXX*X*XXX*X*X*X*XXX*X*X*X*X*X*X*XXXXX*XXXXXXX*XXXXXX
X*X*X***X*****X*******X*****X*X*X*X***X***X*X***X***X***X*X***X*****X***X*X***X*X***X*X*******X*****
X*XXXXX*X*X*XXXXXXXXXXX*XXX*XXX*X*X*X*X*XXX*XXXXX*XXX*X*X*XXXXX*XXXXXXXXX*XXXXX*X*X*X*X*X*XXXXX*XXX*
X*****X*X*X***********X*X***X***X*X*X*X*X***X***X***X*X*X*****X*X*******X***X***X*X*X*X*X*X***X***X*
XXXXX*XXX*X*XXXXXXXXX*X*X*XXX*XXX*X*XXX*X*XXX*X*XXX*XXX*XXXXX*X*X*XXXXXXX*X*X*XXX*XXX*X*XXX*X*XXXXX*
X*****X***X*X***X***X*X*X***X***X*X*X***X*X***X*****X***X*****X*X*******X*X*X*****X***X*****X*X*****
X*XXXXX*X*XXX*X*X*X*X*XXXXX*XXXXX*X*X*XXXXX*XXXXX*XXX*XXXXXXXXXXXXXXXXX*XXX*X*XXXXX*XXXXXXXXXXX*XXX*
X*****X*X*X***X***X*X*****X*******X*X*****X*X***X***X*********X*******X***X*X*X***X*******X***X***X*
XXXXX*X*XXX*X*XXXXX*XXXXX*XXXXXXXXX*XXXXX*X*XXX*X*X*XXX*XXXXX*X*XXXXX*X*X*X*X*XXX*X*XXXXXXX*X*XXX*X*
X*****X*****X*X*****X***X*X*****X***X***X***X***X*X***X*X***X***X*X***X*X*X*X*****X***X*X***X*X***X*
X*XXXXXXX*XXXXX*X*XXX*X*X*X*X*X*X*XXX*X*XXXXX*X*X*XXX*X*XXX*X*XXX*X*XXXXX*X*XXX*XXXXX*X*X*XXX*X*XXX*
X***X***X*X*X***X*X***X*X***X*X*X*X***X*X*****X*X***X*X*****X*X***X*******X***X*X***X***X***X*X*X***
XXX*X*X*X*X*X*XXXXX*XXX*XXXXX*X*X*X*XXX*X*XXXXX*XXX*X*XXXXXXX*X*X*XXXXXXX*XXX*XXX*X*XXXXXXX*X*X*X*X*
X*X***X*X***X*X***X***X*X***X*X*X*X***X***X***X*X***X*X***X***X*X***X***X*X*X***X*X*******X*X***X*X*
X*XXXXX*XXXXX*X*X*XXX*X*X*X*XXX*X*XXX*X*XXXXX*X*X*XXX*X*X*XXXXX*X*X*X*X*X*X*X*X*X*XXXXXXX*X*XXXXX*X*
X*****X***X***X*X*****X*X*X***X*X*****X***X***X*X***X***X*******X*X***X*X***X*X*X*X***X***X***X***X*
XXXXX*XXX*X*XXX*XXXXXXX*X*XXX*X*XXXXX*XXX*X*XXX*XXX*X*XXXXXXXXXXX*XXXXX*XXXXX*X*X*X*X*X*XXXXX*XXXXXX
X***X*****X*X***X*******X***X***X***X*X***X*X***X***X***X***X***X*X***X***X***X*X***X*X*X***X*******
X*X*XXXXXXX*X*XXXXXXXXXXXXX*XXXXX*X*XXX*X*X*XXXXX*XXXXX*X*XXX*X*XXX*X*XXX*X*XXX*XXXXX*X*X*X*XXXXXXX*
X*X*********X***************X*****X*****X*X*******X*****X*****X*****X*****X***X*******X***X*********
XXXXXXXXXXXXXXXXXXXXXXXXXXXXXXXXXXXXXXXXXXXXXXXXXXXXXXXXXXXXXXXXXXXXXXXXXXXXXXXXXXXXXXXXXXXXXXXXXXX*