**XXX**XX*
X*********
*X**X****X
*XXXXX**X*
X***X****X
XXXX****X*
*XX**XX*X*
******X*XX
*XX***X**X
XXX*XXX***