*X*X*XX**X*X*X*XXX*XX***XXXXXXXX**XXX*X***X*X
**XX**XXXXX*X*X***XXX***X*X**XX*XX**X***X**X*
****XXXXX***X*X*X*X*X*XXXXX***X*XXX*XX***XX*X
X***X*X**XX*X*XX**XX*X**X*XX*XX*X*X****X***X*
X*X*****X*X*XXX*X**X*****X***XXX*X**X*X*XXX*X
******XX*XX*X*XXXXX*XXX*X**X*X***XXXXXXXX*XX*
*X*XX****X***X***X***X*XXX*X*XX***XXXX*****XX
XX*X**X****XX**X*XX*XX**XX**X**XX*X*X*X*X**X*
*XX*XX**X****XXX****X*XX****X*X**X*X*****X**X
X*X**X***X****XXX*XX*XX*XX***XX**X***X*XXX*XX
*X**X******X***X**XX***X*X***XXXX***X**X**X**
X****XXXXX*X***X***X*XX*X*XXXX*X*X**X*X*XX*XX
X**XX***XXX*X******X***X******XX*X***XXXXX*X*
XX*X**XX*XXXX*X*XX***XXX*X***XXX***X*XXX***X*
X*XXXX*XX****XXX*X*****X*X*****XX*X**X*XXXX*X
**X*X****X********X***XX*X*X*X***X**X*X**X**X
XX******X**X**X*XX*X**X*X*XXX*X*XX*X**XX**X*X
*XX*X***XX***X*X***XX**X*X*XX*XX*X*X*X***X*XX
X**XX**X**X**X**XX**X***X*XX*XX*XX**X*X*X***X
*X*X*X*XX*X*X***XXX*XX*********X*XX**X*X*X***
X*X***X*X**X*X***X*X***X****X******XX*X**X*X*
X***XXX**XX**X**X**XX**XX***XXX*X*X**XX**X*XX
**X**X****X*XX*******XX***XX**X****X***X**X*X
*X*XX**XX**X*X*X**XX*XXXX*X*X**X**X**XX*X***X
XXXXX*****XX*XX**X*X*X**X**X**X***X*X*XXX**XX
X***XXX*X**X**X*X**X***X*X**X**X***XXX*XXX*XX
*X*X*XX****X***X**X***XX*XX***XX****XXX**X***
*XX*XXX*X*X****XX*X**X**X**XXXX*XXX*XXX**X*XX
XX*X**X***XXXXX**X**X*XX*XXX**X**XX*******XXX
XX*X*XX*XXX*XXXXX*XX**XXX**X*XX**XX*X*X*****X
X*X***X*X***X***X***XX***X********XXX***X**X*
X**X*X*XXXX***X*X*X**X*X*X*XXX**X**XXXX*X**XX
*X*XX**XXX**XX*X*****X*X*X*XX*XXXXXXX**X**X**
*X***XX****X***XX*XXX*XX***X**X**X*X*X****XXX
X*XX****X*X*****X*X**X***X*X****XX**X*X****X*
X*XX**X*****X*XX**X*XX**XX*X**X*X**X*X*X**XX*
*XXX*XXX*X*X*****X*X*XX*X**XX**X*XX*XX**X***X
**X*X***X****X**X*XXX*X****XX******X**XX*****
***XXX*X*XX*X*********XXXXXXXX***X**X**X**X*X
X****X**X*****XXX****XX*XX***XXX*X*X*XXXXX**X
XXXXX***X**XXX**X****X*XX****XX**X***X**X*X*X
XX*X*X****X***XX*XX***XX*XXX*X*X*XX****XXX***
X*X*X**XX*X***XX***X**XX*XX*X*X*X*XX**XX*****
*X*X***X*X**X*X*XX***X***X***X*X****XXXXXXX*X
XX*XXXXXX*X*XX*X*XXX*X**XX*X*XXX*XXX*X*XXX***