*XXXXXXX*X
****XX**X*
*X*X*X*X*X
****X*X**X
**X*XXXX*X
X**XX***XX
******X**X
**XXX***X*
*X*XXX***X
XXXX*X*X**